acorn hall : acorn_hall
antlers : antlers
ashemark : ashemark
ashford : ashford
bandallon : bandallon
banefort : banefort
bitterbridge : bitterbridge
blackcrown : blackcrown
blackhaven : blackhaven
blackmont : blackmont
bloody gate : bloody_gate
brightwater keep : brightwater_keep
bronzegate : bronzegate
castamere : castamere
casterly rock : casterly_rock
castle black : castle_black
castle cerwyn : castle_cerwyn
castle stokeworth : castle_stokeworth
cider hall : cider_hall
the citadel : the_citadel
cleganes keep : cleganes_keep
coldmoat : coldmoat
coldwater : coldwater
the crag : the_crag
crakehall : crakehall
crows nest : crows_nest
deep den : deep_den
deep lake : deep_lake
deepwood motte : deepwood_motte
dragonstone : dragonstone
the dreadfort : the_dreadfort
dyre den : dyre_den
eastwatch-by-the-sea : eastwatch_by_the_sea
evenfall hall : evenfall_hall
the eyrie : the_eyrie
faircastle : faircastle
feastfires : feastfires
felwood : felwood
flints finger : flints_finger
ghost hill : ghost_hill
godsgrace : godsgrace
golden tooth : golden_tooth
goldengrove : goldengrove
grassy vale : grassy_vale
greyguard : greyguard
greywater watch : greywater_watch
griffins roost : griffins_roost
hammerhorn : hammerhorn
harrenhal : harrenhal
haystack hall : haystack_hall
hearts home : hearts_home
hellholt : hellholt
highgarden : highgarden
highpoint : highpoint
honeyholt : honeyholt
horn hill : horn_hill
hornvale : hornvale
hornwood : hornwood
ironoaks : ironoaks
ironrath : ironrath
karhold : karhold
kingsgrave : kingsgrave
last hearth : last_hearth
lemonwood : lemonwood
long barrow : long_barrow
long table : long_table
longbow hall : longbow_hall
mistwood : mistwood
moat cailin : moat_cailin
the nightfort : the_nightfort
nightsong : nightsong
old oak : old_oak
oldcastle : oldcastle
palace of justice : palace_of_justice
pinkmaiden : pinkmaiden
pyke : pyke
queensgate : queensgate
rain house : rain_house
ramsgate : ramsgate
raventree hall : raventree_hall
red keep : red_keep
red lake : red_lake
the redfort : the_redfort
rillwater crossing : rillwater_crossing
riverrun : riverrun
rosby : rosby
runestone : runestone
saltshore : saltshore
sandstone : sandstone
sarsfield : sarsfield
seagard : seagard
sealords palace : sealords_palace
the shadow tower : the_shadow_tower
sharp point : sharp_point
silverhill : silverhill
skyreach : skyreach
snakewood : snakewood
starfall : starfall
stone hedge : stone_hedge
stonedance : stonedance
stonehelm : stonehelm
storms end : storms_end
summerhall : summerhall
sunflower hall : sunflower_hall
sunspear : sunspear
tarbeck hall : tarbeck_hall
ten towers : ten_towers
three towers : three_towers
the tor : the_tor
torrhens square : torrhens_square
tumbleton : tumbleton
the twins : the_twins
unnamed baelish keep : unnamed_baelish_keep
uplands : uplands
vaith : vaith
vultures roost : vultures_roost
the whispers : the_whispers
whitewalls : whitewalls
widows watch : widows_watch
winterfell : winterfell
wyl : wyl
yronwood : yronwood